NO ./xpm/hyusis.xpm
SO ./haraf.xpm
WE ./arevmutq.xpm
EA ./arevelq.xpm

F 220,100,0
C 225,30,0


1111111111111111111111111
1000000000110000000000001
1011000001110000000000001
10010000000000000000000011
11111111111111111111111111
111111111011   100100011101
1111111111111111111111111111
10000000001100000111011111111111111111
11110111111111011100000010001
111101111111111011101010010001
11000000110101011100000010001
1000000000S00000110000000001
10000000000000001101010000001
11000001110101011111011100111
11110111 1110101 101111010001
11111111 1111111 111111111111
