NO ./textures/xpm/bluestone.xpm
SO ./textures/xpm/yellowstone.xpm
WE ./textures/xpm/inesstone.xpm
EA ./textures/xpm/purplestone.xpm

F 149,228,255
C 82, 82, 82

11111111
10000001
10000001
10000001
10N00001
11111111
