NO ./textures/xpm/bluestone.xpm
SO ./textures/xpm/colorstone.xpm
WE ./textures/xpm/redbrick.xpm
EA ./textures/xpm/wood.xpm

F 149,228,255
C 82, 82, 82

111111111111111111111111
1000000000110000000000001
1011000001110000000000001
10010000000000000000000011
11111111111111111111111111
111111111011  100100011101
1111111111111111111111111111
10000000001100000111011111111111111111
1011101111111111110000010001
10000S0000000011101010010001
10001000100000001100000011111
100100000000000010000001
1000000001100001101010011111
1111111111 101011111011100111
1111011111110101110111101001
1111111111 11111111111111111