NO ./xpm/hyusis.xpm
SO ./haraf.xpm
WE ./arevmutq.xpm
EA ./arevelq.xpm

F 220,100,0
C 225,30,0


1
11
101
1001
10001
10001
1N001
100001
1000011111
1000000001
100010011
111111111