NO ./textures/xpm/bluestone.xpm
SO ./textures/xpm/colorstone.xpm
WE ./textures/xpm/redbrick.xpm
EA ./textures/xpm/wood.xpm

F 149,228,255
C 92,92,92

111111111111111111111111
100000W000110000000000001
1011000001110000000000001
10010000000000000000000011
11111111111111111111111111
111111111011  100100011101
1111111111111111111111111111
10000000001100000111011111111111111111
10111111111111111110000010001
10000000000000011101010010001
10001000100000001100000011111
100100000000000010000001
1000000001100001101010011111
1111111111 101011111011100111
1111011111 10101110111101001
1111111111 11111111111111111