NO ./xpm/hyusis.xpm
SO ./haraf.xpm
WE ./arevmutq.xpm
EA ./arevelq.xpm

F 220,100,0
C 225,30,0


1111111111111111111111111
1000000000110000000000001
1011000001110000000000001
10010000000000000000000011
11111111111111111111111111
111111111011   100100011101
1111111111111111111111111111
10000000001100000111011111111111111111
10111111111111111110000010001
1N000000000000011101010010001
10000000000000001100000010001
1000000000000000010000000001
10000000000000001101010000001
11111111111101011111011100111
11110111111101011101111010001
1111111111111111111111111111