NO ./xpm/hyusis.xpm
SO ./haraf.xpm
WE ./arevmutq.xpm
EA ./arevelq.xpm

F 220,100,0
C 225,30,0


11111111111111111111111111111
11110000011100000000000010001
11110010000000000000000010001
11110111101111011100000010001
11110111101111011101010010001
11000000110101011100000000001
11000000110101011101011110001
11000000000000000000000000001
11000000000000000000000000001
110000N0000000000000000000001
11000000000000000000000000001
11111111111111111111111111111