NO ./xpm/hyusis.xpm
SO ./haraf.xpm
WE ./arevmutq.xpm
EA ./arevelq.xpm

F 149,228,255
C 92,92,92


1111111111111111111111111
1000000000110000000000001
1011000001110000000000001
10010000000000000000000011
11111111111111111111111111
111111111011   100100011101
1111111111111111111111111111
10000000001100000111011111111111111111
10111111111111111110000010001
10000000000000011101010010001
10001000100000001100000010001
1001000000000000010000000001
100000N0000000001101010000001
11111111111101011111011100111
11110111111101011101111010001
1111111111111111111111111111